    ####
	# E#
########
#    #
#### #####
  #      #
  ###### ####
       #    #
	   ####S#
###########	#
#          F# 
#          ###
#            #
############## 