################################################
#S                                            F#
########################### ####################
                          # #
						  # #
						  # #
						  # #
						  # #
						  # #
					####### #
					#L      #
					####### #
					      # #
						  #E#
						  ###