        ####
	# E#
    ########
    #L     #
    #### #####
      #      #
      ###### ####
           #    #
	   ####S#
   ############	#
   #           F# 
   #          ###
   #            #
   ############## 
