############################################################
#F                                                 S      L# 
#####################################################      #
                                                    #      #
	  E					    #      #
    		        	       		    #      #
						    #      #
						    ########
