                 ##################
		 #       #        #
		 #       # #      #
		 #      L#E#      #
		 #  ########      #
		 #                #
####################### ############################
#                     #                       #F   #
#    ########         #                       #    #
#          S#         #############           ##   #
#############                #                 ##  #
#                     #      #                     #
#                ######      #                     #
#                #                                 #
####################################################
